M_________________S_________________M
M___________________________________M
M___________________________________M
M___________________________________M
M___________________________________M
M___________________________________M
M___________________________________M
M___________________________________M
M___________________________________M
M___________________________________M
M___________________________________M
M___________________________________M
M___________________________________M
M___________________________________M
M___________________________________M
M___________________________________M
M___________________________________M
M___________________________________M
M___________________________________M
M___________________________________M
M___________________________________M
M___________________________________M
M___________________________________M
M___________________________________M
M___________________________________M
M___________________________________M
M___________________________________M
M___________________________________M
M___________________________________M
M___________________________________M
M___________________________________M
M___________________________________M
M___________________________________M
M___________________________________M
M___________________________________M
M___________________________________M
M___________________________________M
M___________________________________M
M___________________________________M
M___________________________________M
M___________________________________M
M___________________________________M
M___________________________________M
M___________________________________M
M___________________________________M
M___________________________________M
M___________________________________M
M___________________________________M
M___________________________________M
M_________________G_________________M